#module 0 size: 18 bs: 9.77894e-101
7 10 13 17 18 22 28 31 33 37 38 41 44 45 47 50 51 56 
#module 1 size: 26 bs: 7.03784e-11
103 106 114 116 121 123 136 139 140 141 142 143 144 146 147 148 149 151 155 159 160 166 171 175 176 183 
#module 2 size: 14 bs: 0.00992275
6 14 20 39 42 52 54 55 58 65 66 67 71 97 
#module 3 size: 59 bs: 1.55528e-10
201 203 204 206 208 210 211 212 213 216 217 218 219 222 223 224 225 226 227 229 230 232 234 237 239 242 243 244 245 247 248 249 253 254 256 259 262 263 264 265 266 267 270 272 274 276 277 282 284 285 286 288 289 291 294 295 296 297 299 
#module 4 size: 12 bs: 0.025766
214 215 252 275 278 279 281 287 290 293 298 300 
#module 5 size: 13 bs: 0.0322774
124 135 145 154 161 167 179 182 184 185 187 188 200 
#module 6 size: 47 bs: 6.9534e-08
102 107 111 112 117 119 120 125 126 127 128 130 132 133 134 137 138 150 152 153 156 157 158 162 165 168 169 170 171 172 174 177 180 181 186 189 190 191 192 193 194 195 196 197 198 199 200 
#module 7 size: 28 bs: 6.10512e-13
1 2 3 4 9 15 21 23 27 30 34 43 46 48 49 53 60 63 68 70 72 73 74 78 79 81 83 93 
#module 8 size: 35 bs: 1.17817e-12
5 11 16 25 32 35 36 40 57 61 62 64 69 75 76 77 80 82 84 85 86 87 88 89 90 91 92 93 94 95 96 97 98 99 100 
#module 0 size: 28 bs: 6.10512e-13
1 2 3 4 9 15 21 23 27 30 34 43 46 48 49 53 60 63 68 70 72 73 74 78 79 81 83 93 
#module 1 size: 18 bs: 2.09897e-101
7 10 13 17 18 22 28 31 33 37 38 41 44 45 47 50 51 56 
#module 2 size: 26 bs: 7.03785e-11
103 106 114 116 121 123 136 139 140 141 142 143 144 146 147 148 149 151 155 159 160 166 171 175 176 183 
#module 3 size: 35 bs: 1.17817e-12
5 11 16 25 32 35 36 40 57 61 62 64 69 75 76 77 80 82 84 85 86 87 88 89 90 91 92 93 94 95 96 97 98 99 100 
#module 4 size: 14 bs: 0.00992275
6 14 20 39 42 52 54 55 58 65 66 67 71 97 
#module 5 size: 53 bs: 6.18194e-08
201 203 204 206 208 210 212 213 216 217 218 222 224 225 226 227 230 232 234 237 239 242 244 245 247 249 253 254 256 259 262 263 264 265 266 267 270 272 274 276 277 282 284 285 286 288 289 291 294 295 296 297 299 
#module 6 size: 13 bs: 3.26783e-09
214 215 252 268 275 278 279 281 287 290 293 298 300 
#module 7 size: 13 bs: 0.0313196
124 135 145 154 161 167 179 182 184 185 187 188 200 
#module 8 size: 42 bs: 0.0322774
102 111 112 117 119 125 126 127 128 132 133 134 137 138 150 152 153 157 158 162 165 168 169 170 171 172 174 177 180 181 186 189 190 191 192 193 194 195 196 197 198 199 
#module 0 size: 28 bs: 6.10512e-13
1 2 3 4 9 15 21 23 27 30 34 43 46 48 49 53 60 63 68 70 72 73 74 78 79 81 83 93 
#module 1 size: 18 bs: 5.55848e-101
7 10 13 17 18 22 28 31 33 37 38 41 44 45 47 50 51 56 
#module 2 size: 26 bs: 7.03786e-11
103 106 114 116 121 123 136 139 140 141 142 143 144 146 147 148 149 151 155 159 160 166 171 175 176 183 
#module 3 size: 35 bs: 1.17817e-12
5 11 16 25 32 35 36 40 57 61 62 64 69 75 76 77 80 82 84 85 86 87 88 89 90 91 92 93 94 95 96 97 98 99 100 
#module 4 size: 14 bs: 0.00992276
6 14 20 39 42 52 54 55 58 65 66 67 71 97 
#module 5 size: 52 bs: 4.19976e-08
201 203 206 208 211 212 213 216 217 219 222 223 224 225 226 230 232 234 237 239 242 244 245 247 248 249 253 254 256 259 262 263 264 265 266 267 270 272 274 276 277 282 284 285 286 288 289 291 294 295 296 297 
#module 6 size: 13 bs: 0.0313196
214 215 252 268 275 278 279 281 287 290 293 298 300 
#module 7 size: 13 bs: 0.0322774
124 135 145 154 161 167 179 182 184 185 187 188 200 
#module 8 size: 47 bs: 6.95341e-08
102 107 111 112 117 119 120 125 126 127 128 130 132 133 134 137 138 150 152 153 156 157 158 162 165 168 169 170 171 172 174 177 180 181 186 189 190 191 192 193 194 195 196 197 198 199 200 
#module 0 size: 28 bs: 6.10512e-13
1 2 3 4 9 15 21 23 27 30 34 43 46 48 49 53 60 63 68 70 72 73 74 78 79 81 83 93 
#module 1 size: 18 bs: 8.3155e-101
7 10 13 17 18 22 28 31 33 37 38 41 44 45 47 50 51 56 
#module 2 size: 73 bs: 5.91046e-101
201 203 204 205 206 208 210 211 212 213 214 215 216 217 218 219 222 223 224 225 226 227 229 230 232 234 237 239 240 242 243 244 245 247 248 249 252 253 254 256 259 262 263 264 265 266 267 270 272 274 275 276 277 278 279 281 282 284 285 286 287 288 289 290 291 293 294 295 296 297 298 299 300 
#module 3 size: 26 bs: 1.30247e-10
103 106 114 116 121 123 136 139 140 141 142 143 144 146 147 148 149 151 155 159 160 166 171 175 176 183 
#module 4 size: 35 bs: 1.17817e-12
5 11 16 25 32 35 36 40 57 61 62 64 69 75 76 77 80 82 84 85 86 87 88 89 90 91 92 93 94 95 96 97 98 99 100 
#module 5 size: 14 bs: 0.00992276
6 14 20 39 42 52 54 55 58 65 66 67 71 97 
#module 6 size: 14 bs: 0.028116
124 129 135 145 154 161 167 179 182 184 185 187 188 200 
#module 7 size: 47 bs: 6.9534e-08
102 107 111 112 117 119 120 125 126 127 128 130 132 133 134 137 138 150 152 153 156 157 158 162 165 168 169 170 171 172 174 177 180 181 186 189 190 191 192 193 194 195 196 197 198 199 200 
#module 0 size: 28 bs: 6.10512e-13
1 2 3 4 9 15 21 23 27 30 34 43 46 48 49 53 60 63 68 70 72 73 74 78 79 81 83 93 
#module 1 size: 18 bs: 6.02781e-101
7 10 13 17 18 22 28 31 33 37 38 41 44 45 47 50 51 56 
#module 2 size: 26 bs: 7.03785e-11
103 106 114 116 121 123 136 139 140 141 142 143 144 146 147 148 149 151 155 159 160 166 171 175 176 183 
#module 3 size: 35 bs: 1.17817e-12
5 11 16 25 32 35 36 40 57 61 62 64 69 75 76 77 80 82 84 85 86 87 88 89 90 91 92 93 94 95 96 97 98 99 100 
#module 4 size: 14 bs: 0.00992276
6 14 20 39 42 52 54 55 58 65 66 67 71 97 
#module 5 size: 54 bs: 6.90637e-08
203 204 206 208 210 211 212 216 217 218 219 222 224 225 226 227 229 230 232 234 237 239 242 243 245 247 248 249 253 254 259 262 263 264 265 266 267 270 272 274 276 277 282 284 285 286 288 289 291 294 295 296 297 299 
#module 6 size: 13 bs: 0.0313196
214 215 252 268 275 278 279 281 287 290 293 298 300 
#module 7 size: 13 bs: 0.0322773
124 135 145 154 161 167 179 182 184 185 187 188 200 
#module 8 size: 47 bs: 6.9534e-08
102 107 111 112 117 119 120 125 126 127 128 130 132 133 134 137 138 150 152 153 156 157 158 162 165 168 169 170 171 172 174 177 180 181 186 189 190 191 192 193 194 195 196 197 198 199 200 
#module 0 size: 28 bs: 6.10512e-13
1 2 3 4 9 15 21 23 27 30 34 43 46 48 49 53 60 63 68 70 72 73 74 78 79 81 83 93 
#module 1 size: 18 bs: 3.18487e-101
7 10 13 17 18 22 28 31 33 37 38 41 44 45 47 50 51 56 
#module 2 size: 26 bs: 1.30248e-10
103 106 114 116 121 123 136 139 140 141 142 143 144 146 147 148 149 151 155 159 160 166 171 175 176 183 
#module 3 size: 35 bs: 1.17817e-12
5 11 16 25 32 35 36 40 57 61 62 64 69 75 76 77 80 82 84 85 86 87 88 89 90 91 92 93 94 95 96 97 98 99 100 
#module 4 size: 14 bs: 0.00992275
6 14 20 39 42 52 54 55 58 65 66 67 71 97 
#module 5 size: 55 bs: 3.83109e-09
206 208 210 211 212 213 216 217 218 219 222 223 224 225 226 227 229 230 232 234 237 239 242 243 244 245 247 248 249 253 254 256 259 262 263 264 265 266 267 270 272 274 276 277 282 284 285 286 288 289 291 294 295 296 297 
#module 6 size: 13 bs: 0.0313196
214 215 252 268 275 278 279 281 287 290 293 298 300 
#module 7 size: 14 bs: 0.028116
124 129 135 145 154 161 167 179 182 184 185 187 188 200 
#module 8 size: 47 bs: 6.9534e-08
102 107 111 112 117 119 120 125 126 127 128 130 132 133 134 137 138 150 152 153 156 157 158 162 165 168 169 170 171 172 174 177 180 181 186 189 190 191 192 193 194 195 196 197 198 199 200 
#module 0 size: 28 bs: 6.10512e-13
1 2 3 4 9 15 21 23 27 30 34 43 46 48 49 53 60 63 68 70 72 73 74 78 79 81 83 93 
#module 1 size: 18 bs: 6.0757e-101
7 10 13 17 18 22 28 31 33 37 38 41 44 45 47 50 51 56 
#module 2 size: 26 bs: 1.30248e-10
103 106 114 116 121 123 136 139 140 141 142 143 144 146 147 148 149 151 155 159 160 166 171 175 176 183 
#module 3 size: 35 bs: 1.17817e-12
5 11 16 25 32 35 36 40 57 61 62 64 69 75 76 77 80 82 84 85 86 87 88 89 90 91 92 93 94 95 96 97 98 99 100 
#module 4 size: 14 bs: 0.00992275
6 14 20 39 42 52 54 55 58 65 66 67 71 97 
#module 5 size: 12 bs: 0.0326581
214 215 252 275 278 279 281 287 290 293 298 300 
#module 6 size: 58 bs: 1.95379e-10
201 203 204 206 208 210 211 212 213 216 217 218 219 222 223 224 225 226 227 229 230 232 234 237 239 242 243 244 245 247 248 249 253 254 256 259 262 263 264 265 266 267 270 272 274 276 277 282 284 285 286 288 289 291 294 295 296 297 
#module 7 size: 14 bs: 0.0281161
124 129 135 145 154 161 167 179 182 184 185 187 188 200 
#module 8 size: 47 bs: 6.9534e-08
102 107 111 112 117 119 120 125 126 127 128 130 132 133 134 137 138 150 152 153 156 157 158 162 165 168 169 170 171 172 174 177 180 181 186 189 190 191 192 193 194 195 196 197 198 199 200 
#module 0 size: 28 bs: 6.10512e-13
1 2 3 4 9 15 21 23 27 30 34 43 46 48 49 53 60 63 68 70 72 73 74 78 79 81 83 93 
#module 1 size: 18 bs: 3.82459e-101
7 10 13 17 18 22 28 31 33 37 38 41 44 45 47 50 51 56 
#module 2 size: 26 bs: 7.03785e-11
103 106 114 116 121 123 136 139 140 141 142 143 144 146 147 148 149 151 155 159 160 166 171 175 176 183 
#module 3 size: 35 bs: 1.17817e-12
5 11 16 25 32 35 36 40 57 61 62 64 69 75 76 77 80 82 84 85 86 87 88 89 90 91 92 93 94 95 96 97 98 99 100 
#module 4 size: 14 bs: 0.00992275
6 14 20 39 42 52 54 55 58 65 66 67 71 97 
#module 5 size: 12 bs: 0.0542365
214 215 252 275 278 281 287 290 293 298 299 300 
#module 6 size: 56 bs: 2.34645e-08
201 203 204 206 208 210 211 212 213 216 217 218 219 222 223 224 225 226 227 229 230 232 234 237 239 242 243 244 245 247 249 253 254 256 259 262 264 265 266 267 270 272 274 276 277 282 284 285 286 288 289 291 294 295 296 297 
#module 7 size: 13 bs: 0.0322774
124 135 145 154 161 167 179 182 184 185 187 188 200 
#module 8 size: 44 bs: 3.21327e-06
102 107 111 112 117 119 125 126 127 128 132 133 134 137 138 150 152 153 156 157 158 162 165 168 169 170 171 172 174 177 180 181 186 189 190 191 192 193 194 195 196 197 198 199 
#module 0 size: 28 bs: 6.10512e-13
1 2 3 4 9 15 21 23 27 30 34 43 46 48 49 53 60 63 68 70 72 73 74 78 79 81 83 93 
#module 1 size: 18 bs: 1.22909e-101
7 10 13 17 18 22 28 31 33 37 38 41 44 45 47 50 51 56 
#module 2 size: 26 bs: 7.03784e-11
103 106 114 116 121 123 136 139 140 141 142 143 144 146 147 148 149 151 155 159 160 166 171 175 176 183 
#module 3 size: 35 bs: 1.17817e-12
5 11 16 25 32 35 36 40 57 61 62 64 69 75 76 77 80 82 84 85 86 87 88 89 90 91 92 93 94 95 96 97 98 99 100 
#module 4 size: 14 bs: 0.00992276
6 14 20 39 42 52 54 55 58 65 66 67 71 97 
#module 5 size: 54 bs: 5.35082e-09
201 203 206 208 210 211 212 213 216 217 219 222 223 224 225 226 230 232 234 237 239 242 243 244 245 247 248 249 253 254 256 259 262 263 264 265 266 267 270 272 274 276 277 282 284 285 286 288 289 291 294 295 296 297 
#module 6 size: 12 bs: 0.0326581
214 215 252 275 278 279 281 287 290 293 298 300 
#module 7 size: 13 bs: 0.0322773
124 135 145 154 161 167 179 182 184 185 187 188 200 
#module 8 size: 47 bs: 6.9534e-08
102 107 111 112 117 119 120 125 126 127 128 130 132 133 134 137 138 150 152 153 156 157 158 162 165 168 169 170 171 172 174 177 180 181 186 189 190 191 192 193 194 195 196 197 198 199 200 
#module 0 size: 28 bs: 6.10512e-13
1 2 3 4 9 15 21 23 27 30 34 43 46 48 49 53 60 63 68 70 72 73 74 78 79 81 83 93 
#module 1 size: 18 bs: 8.13563e-102
7 10 13 17 18 22 28 31 33 37 38 41 44 45 47 50 51 56 
#module 2 size: 26 bs: 1.30247e-10
103 106 114 116 121 123 136 139 140 141 142 143 144 146 147 148 149 151 155 159 160 166 171 175 176 183 
#module 3 size: 35 bs: 1.17817e-12
5 11 16 25 32 35 36 40 57 61 62 64 69 75 76 77 80 82 84 85 86 87 88 89 90 91 92 93 94 95 96 97 98 99 100 
#module 4 size: 14 bs: 0.00992276
6 14 20 39 42 52 54 55 58 65 66 67 71 97 
#module 5 size: 57 bs: 6.25235e-10
201 203 204 206 208 210 211 212 213 216 217 219 222 223 224 225 226 227 230 232 234 237 239 242 243 244 245 247 248 249 253 254 256 259 262 263 264 265 266 267 270 272 274 276 277 282 284 285 286 288 289 291 294 295 296 297 299 
#module 6 size: 13 bs: 0.00587698
214 215 252 268 275 278 279 281 287 290 293 298 300 
#module 7 size: 14 bs: 0.0281161
124 129 135 145 154 161 167 179 182 184 185 187 188 200 
#module 8 size: 47 bs: 6.9534e-08
102 107 111 112 117 119 120 125 126 127 128 130 132 133 134 137 138 150 152 153 156 157 158 162 165 168 169 170 171 172 174 177 180 181 186 189 190 191 192 193 194 195 196 197 198 199 200 
